35 5 15
7 13
.............
.X--+----F...
....|........
....+----P...
.............
.............
.............