38 4 10
9 15
...............
.------P-|.-P|.
.........|...P.
.+---+-|.--|.|.
.X...|.|...|.|.
.|-|.|.P--.|.|.
...|.|.....|.|.
.-F+.------P--.
...............
