46 5 10
15 31
...............................
.------|.------+---P-----|.--|.
.......|.......|.........|...|.
.+-+--.--|.+-|.|.+----P|.|.+-|.
.|.|.....|.|.|.|.|.....|.|.|.|.
.-.|.+-|.--P.|.|.|.--|.|.---.|.
...|.|.|.....|.|.|...|.P.....|.
.+-|.|.----|.|.-----F|.--|.---.
.|.|.|.....|.|.......|...|.....
.|.-.--|.+--.|.+P--|.|.|.|.+P|.
.|.....|.|...|.|...|.|.|.|.|.|.
.|.+-|.|.-----.--|.|.P--.---.|.
.|.|.|.|.........|.|.........|.
.---.------------X.-------P---.
...............................
