49 5 13
15 31
...............................
.--|.+-|.----+-+--.+-+-|.+-|.|.
...|.|.|.....|.|...|.|.|.|.|.|.
.|.---.----|.|.P----.|.--X.|.|.
.|.........|.|.......|.....|.|.
.+---+-|.|.|.--|.+----.+--.--|.
.|...|.|.|.|...|.|.....|.....|.
.|.+--.--|.|.---.|.+-|.+----P-.
.|.|.....|.|.....|.|.|.P.......
.|.---F|.-.-------.-.|.----|.P.
.|.....|.............|.....|.|.
.--P-|.|.+-|.+---+----.+-|.|.P.
.....|.|.|.|.|...|.....|.|.|.P.
.-----.---.-----.-------.-P---.
...............................
