41 6 20
11 11
...........
.--P.-PF-|.
...|.....|.
.P.|.+--P|.
.|.|.|...|.
.|.P--.|.X.
.|.....|.|.
.P-+----.|.
.|.|.....|.
.-.---P---.
...........
