30 5 10
7 10
P-+...+--+
|.X...|..|
+.+PI-+..P
|.|...P..|
P.|...FP-+
|.|......|
+-P------+
