59 3 11
11 21
.....................
.|.--+-+---|.P-+-+--.
.|...P.|...|...P.|...
.--P.-.--|.--|.-.-X|.
...|.....|...|.....|.
.+--.+----.|.------|.
.|...|.....|.......|.
.--|.|.|.+---P.+-|.|.
...|.P.|.|...F.|.|.|.
.-P---.P----.---.---.
.....................
