44 5 11
21 11
...........
.---P|.+-|.
.....|.P.|.
.--P.|.-.P.
...|.|...|.
.+P-.----|.
.|.......|.
.+-+--.+--.
.|.|...|...
.X.|.+-P.|.
.|.|.|...|.
.-.|.F---|.
...P.....|.
.+------.|.
.|.......|.
.|.+P-----.
.|.P.......
.|.--|.+-|.
.|...|.|.|.
.-----P-.-.
...........
