15 5 10
7 10
P-+...+--+
|.X...|..|
+-+-P-+..P
|.|...P..|
P.|...FP-+
|.|......|
+-P------+
