50 3 15
9 15
...............
.X-P--+-------.
......|.......|
......+--P--+-F
............|..
............|..
............P..
...............
...............