40 2 10
7 15
...............
.X--+----P----+
....|.........|
....+---F---P-+
..............|
.-------------+
...............