58 3 18
11 17
.................
.----|.---P+P+--.
.....P.....|.|...
.+-|.----|.|.--|.
.|.|.....|.|...|.
.|.+-|.+P-.---.|.
.|.|.|.|.......|.
.|.|.-.--|.+---|.
.|.|.....P.|...|.
.-.------XF-.--P.
.................
