47 5 12
15 31
...............................
.|.+-----P.+-+---------|.+----.
.|.|.....|.|.|.........|.|.....
.|.--+-|.-.|.--|.+-P-|.|.--+-|.
.|...|.|...|...|.|...|.|...|.|.
.--|.-.--|.|.+--.-.+--.--|.-.|.
...|.....|.|.|.....|.....|...|.
.|.P.+-|.---.----|.|.+--P-.+--.
.P.|.|.|.........|.|.|.....|...
.|.---.-----------.P.|.------P.
.|.................|.|.......|.
.+---+--.+------X--|.--|.+---|.
.|...|...|.........|...|.|...|.
.---.----P------F-.-------.---.
...............................
