48 7 12
9 15
...............
.|.-X--+-----|.
.P.....|.....|.
.|.+----.F-|.|.
.|.|.......P.P.
.|.|.|.+-P--.|.
.|.|.|.|.|...|.
.---.---.-P---.
...............
